filiere_id,filiere_libelle,cod_aff_form,effectif_total_demandé,effectif_total_candidats,effectif_total_candidates,effectif_total_accepte,effectif_total_admis,effectif_total_admises,general,techno,pro,autre,capacite
1377,BUT - Carrières juridiques (Seconde année en apprentissage),35179,1437,228,1209,34,4,30,10,18,2,4,36
2718,BUT - Mesures physiques,4099,2322,1779,543,114,92,22,62,20,0,32,102
1377,BUT - Carrières juridiques (Seconde année en apprentissage),36064,372,74,298,19,5,14,11,4,0,4,25
857,BUT - Carrières juridiques,7130,3580,876,2704,177,45,132,60,86,0,31,183
209,BUT - Carrières sociales Parcours animation sociale et socioculturelle,7111,1132,217,915,54,6,48,4,16,0,34,66
2349,BUT - Carrières sociales Parcours éducation spécialisée,7114,909,131,778,81,12,69,16,25,0,40,79
1817,BUT - Carrières sociales parcours villes et territoires durables,7115,349,119,230,22,13,9,10,2,0,10,32
2296,BUT - Chimie,6885,1237,504,733,71,31,40,41,12,0,18,90
679,BUT - Génie biologique parcours biologie médicale et biotechnologie,6892,2692,742,1950,41,13,28,17,19,0,5,42
494,BUT - Génie biologique Parcours diététique et nutrition,6890,1244,275,969,22,4,18,7,6,0,9,23
3512,BUT - Génie biologique parcours sciences de l'aliment et biotechnologie,6891,1110,385,725,30,8,22,13,6,0,11,46
984,BUT - Génie électrique et informatique industrielle,6886,986,893,93,68,62,6,29,12,0,27,86
428,BUT - Génie mécanique et productique (Seconde année possible en apprentissage),6887,1353,1221,132,77,75,2,32,32,0,13,88
3304,BUT - Gestion des entreprises et des administrations,6894,4213,2234,1979,166,82,84,73,72,1,20,173
1722,BUT - Information communication Parcours communication des organisations,7112,1408,333,1075,56,14,42,23,18,0,15,58
1549,BUT - Information communication Parcours métiers du livre et du patrimoine,7113,404,54,350,16,0,16,8,2,0,6,16
2326,BUT - Informatique,6888,1951,1792,159,133,127,6,55,58,0,20,135
116,BUT - Management de la Logistique et des Transports,7110,638,486,152,62,50,12,24,22,4,12,80
1156,BUT - Mesures physiques (Seconde année possible en apprentissage),6889,944,720,224,48,37,11,28,7,0,13,84
1300,BUT - Statistique et informatique décisionnelle,7128,728,601,127,73,58,15,33,8,0,32,80
1218,BUT - Techniques de commercialisation,7129,4194,2223,1971,187,72,115,86,88,0,13,183
3389,BUT - Génie civil - Construction durable,6089,1457,1162,295,129,105,24,70,46,0,13,130
858,BUT - Génie mécanique et productique,6090,638,578,60,51,47,4,27,16,0,8,52
3304,BUT - Gestion des entreprises et des administrations,6094,1776,892,884,135,62,73,53,61,0,21,135
2326,BUT - Informatique,6091,1463,1324,139,119,115,4,69,24,0,26,120
116,BUT - Management de la Logistique et des Transports,6095,477,372,105,55,46,9,20,17,2,16,56
2718,BUT - Mesures physiques,6092,530,409,121,26,17,9,17,3,0,6,50
2566,"BUT - Packaging, emballage et conditionnement",6093,337,149,188,43,15,28,25,8,0,10,50
1218,BUT - Techniques de commercialisation,6096,2161,1101,1060,117,43,74,38,58,4,17,106
2326,BUT - Informatique,8901,1586,1445,141,111,101,10,43,54,0,14,105
209,BUT - Carrières sociales Parcours animation sociale et socioculturelle,4871,645,152,493,54,16,38,12,17,0,25,52
679,BUT - Génie biologique parcours biologie médicale et biotechnologie,4868,1700,468,1232,55,19,36,29,19,0,7,50
494,BUT - Génie biologique Parcours diététique et nutrition,4866,758,187,571,27,4,23,10,4,0,13,23
1419,BUT - Génie biologique parcours sciences de l'environnement et écotechnologies,4867,712,365,347,27,9,18,17,8,0,2,23
984,BUT - Génie électrique et informatique industrielle,4865,895,836,59,78,73,5,39,20,0,19,88
3304,BUT - Gestion des entreprises et des administrations,4869,3205,1630,1575,159,80,79,83,63,0,13,132
1722,BUT - Information communication Parcours communication des organisations,4873,1529,379,1150,28,6,22,13,10,0,5,28
3251,BUT - Information communication Parcours information numérique dans les organisations,4872,475,205,270,22,11,11,6,2,0,14,28
1218,BUT - Techniques de commercialisation,4870,4757,2342,2415,193,77,116,98,93,0,2,188
2718,BUT - Mesures physiques,9544,1552,1162,390,88,59,29,49,11,1,27,94
2296,BUT - Chimie,4964,1853,824,1029,100,48,52,64,20,0,16,120
3389,BUT - Génie civil - Construction durable,4965,2649,2146,503,122,97,25,58,52,0,12,120
984,BUT - Génie électrique et informatique industrielle,4966,1205,1107,98,103,102,1,58,25,0,20,140
858,BUT - Génie mécanique et productique,4967,2360,2139,221,83,74,9,39,26,0,18,100
2718,BUT - Mesures physiques,4969,1879,1450,429,93,77,16,72,2,0,19,95
624,BUT - Métiers de la Transition et de l'Efficacité Énergétiques,4968,1071,916,155,82,78,4,43,35,0,4,122
2653,BUT - Métiers du multimédia et de l'internet,4971,2622,1780,842,108,59,49,41,40,0,27,109
3380,BUT - Réseaux et télécommunications,4970,1072,985,87,77,68,9,46,23,0,8,78
3389,BUT - Génie civil - Construction durable,4972,199,170,29,19,15,4,0,0,19,0,22
984,BUT - Génie électrique et informatique industrielle,4973,144,139,5,21,19,2,0,0,21,0,22
858,BUT - Génie mécanique et productique,14474,137,129,8,18,17,1,0,0,17,1,22
3380,BUT - Réseaux et télécommunications,4974,135,125,10,14,14,0,0,0,12,2,20
857,BUT - Carrières juridiques,4999,1788,410,1378,141,26,115,59,57,2,23,145
209,BUT - Carrières sociales Parcours animation sociale et socioculturelle,5000,394,78,316,25,8,17,6,6,1,12,28
745,BUT - Carrières sociales Parcours assistance sociale,5001,477,28,449,28,1,27,9,8,1,10,28
2349,BUT - Carrières sociales Parcours éducation spécialisée,5005,813,107,706,28,4,24,4,9,1,14,28
3304,BUT - Gestion des entreprises et des administrations,4997,2028,1033,995,137,58,79,63,65,0,9,140
1722,BUT - Information communication Parcours communication des organisations,5003,1244,264,980,60,11,49,29,25,0,6,54
3251,BUT - Information communication Parcours information numérique dans les organisations,5002,264,104,160,28,16,12,11,8,0,9,26
1549,BUT - Information communication Parcours métiers du livre et du patrimoine,5004,424,65,359,27,4,23,12,5,1,9,26
2326,BUT - Informatique,4996,1520,1374,146,122,112,10,71,37,0,14,115
1218,BUT - Techniques de commercialisation,4998,2277,1137,1140,62,18,44,27,29,0,6,56
1300,BUT - Statistique et informatique décisionnelle,5136,510,407,103,45,37,8,28,3,0,14,50
3304,BUT - Gestion des entreprises et des administrations,5137,1153,613,540,81,41,40,38,35,0,8,84
1817,BUT - Carrières sociales parcours villes et territoires durables,2709,613,215,398,68,23,45,27,16,1,24,84
858,BUT - Génie mécanique et productique,2699,1949,1752,197,105,94,11,37,36,1,31,96
3304,BUT - Gestion des entreprises et des administrations,2704,3646,1768,1878,131,54,77,64,57,0,10,135
1549,BUT - Information communication Parcours métiers du livre et du patrimoine,2708,702,124,578,56,5,51,22,6,0,28,53
2326,BUT - Informatique,2701,2540,2262,278,106,100,6,52,48,0,6,108
116,BUT - Management de la Logistique et des Transports,2705,854,581,273,91,58,33,35,44,1,11,90
1218,BUT - Techniques de commercialisation,2706,5734,2699,3035,143,50,93,59,73,0,11,140
2948,BUT - Hygiène Sécurité Environnement,2700,1057,735,322,94,72,22,43,30,1,20,104
3389,BUT - Génie civil - Construction durable,30795,1840,1484,356,27,19,8,9,11,0,7,28
3380,BUT - Réseaux et télécommunications,2702,1135,986,149,56,50,6,25,26,0,5,56
2296,BUT - Chimie,2713,1429,575,854,95,36,59,36,39,0,20,104
3382,BUT - Génie chimique génie des procédés,2714,780,359,421,57,21,36,30,14,0,13,56
984,BUT - Génie électrique et informatique industrielle,2715,1006,909,97,85,84,1,42,22,0,21,104
2718,BUT - Mesures physiques,8902,1313,993,320,70,54,16,54,5,0,11,84
3304,BUT - Gestion des entreprises et des administrations,2720,3157,1573,1584,133,64,69,60,63,0,10,135
2718,BUT - Mesures physiques,2717,1206,924,282,98,74,24,56,8,0,34,104
624,BUT - Métiers de la Transition et de l'Efficacité Énergétiques,2716,711,620,91,48,45,3,22,15,0,11,72
1218,BUT - Techniques de commercialisation,2721,3441,1644,1797,64,27,37,28,30,0,6,60
950,BUT - Génie biologique Parcours agronomie (Seconde année possible en apprentissage),5864,1028,496,532,30,12,18,14,11,0,5,30
679,BUT - Génie biologique parcours biologie médicale et biotechnologie,5866,2635,740,1895,41,9,32,15,20,0,6,38
2676,BUT - Génie biologique parcours sciences de l'aliment et biotechnologie (Seconde année possible en apprentissage),5865,659,230,429,39,12,27,24,12,0,3,38
984,BUT - Génie électrique et informatique industrielle,5862,1246,1147,99,83,76,7,40,35,0,8,80
858,BUT - Génie mécanique et productique,5863,1647,1532,115,35,34,1,14,17,0,4,35
3304,BUT - Gestion des entreprises et des administrations,5867,4216,2256,1960,174,99,75,86,80,0,8,162
2053,BUT - Techniques de commercialisation (Seconde année possible en apprentissage),5868,6108,3014,3094,139,41,98,63,69,0,7,140
745,BUT - Carrières sociales Parcours assistance sociale,5869,1331,112,1219,49,3,46,21,10,0,18,56
332,BUT - Gestion administrative et commerciale des organisations,35060,1848,796,1052,56,19,37,28,21,0,7,56
984,BUT - Génie électrique et informatique industrielle,3012,482,443,39,25,24,1,7,4,3,11,54
858,BUT - Génie mécanique et productique,3013,740,674,66,48,46,2,31,11,0,6,54
2653,BUT - Métiers du multimédia et de l'internet,3015,1650,1156,494,66,48,18,34,19,0,13,66
3131,"BUT - Qualité, logistique industrielle et organisation",3014,303,214,89,26,23,3,7,9,0,10,31
1218,BUT - Techniques de commercialisation,3016,1893,961,932,83,36,47,35,39,0,9,86
1265,BUT - Carrières sociales parcours coordination et gestion des établissements et services sanitaires et sociaux,20532,361,51,310,57,6,51,11,25,4,17,60
984,BUT - Génie électrique et informatique industrielle,8899,818,761,57,85,80,5,54,21,0,10,100
2683,BUT - Génie électrique et informatique industrielle - Section aménagée,8907,35,34,1,6,6,0,4,1,1,0,16
858,BUT - Génie mécanique et productique,8900,1652,1524,128,108,103,5,48,47,0,13,104
1329,BUT - Génie mécanique et productique - Section aménagée,8908,77,74,3,12,12,0,10,2,0,0,14
3304,BUT - Gestion des entreprises et des administrations,8905,2621,1364,1257,112,59,53,47,49,0,16,115
3131,"BUT - Qualité, logistique industrielle et organisation",8903,475,349,126,75,54,21,37,21,0,17,90
3380,BUT - Réseaux et télécommunications,8904,838,761,77,60,59,1,36,20,0,4,60
1218,BUT - Techniques de commercialisation,8906,3098,1633,1465,124,49,75,54,61,0,9,115
209,BUT - Carrières sociales Parcours animation sociale et socioculturelle,4332,1192,250,942,118,33,85,28,33,2,55,120
1817,BUT - Carrières sociales parcours villes et territoires durables,13843,239,96,143,30,12,18,14,3,0,13,30
1722,BUT - Information communication Parcours communication des organisations,4335,1524,322,1202,30,2,28,15,13,0,2,30
3251,BUT - Information communication Parcours information numérique dans les organisations,4333,493,206,287,27,12,15,14,10,0,3,30
1549,BUT - Information communication Parcours métiers du livre et du patrimoine,4336,763,123,640,59,10,49,28,5,1,25,60
1752,BUT - Information communication Parcours publicité,4334,628,142,486,30,7,23,16,13,0,1,30
2653,BUT - Métiers du multimédia et de l'internet,4331,1077,788,289,49,32,17,12,22,0,15,50
679,BUT - Génie biologique parcours biologie médicale et biotechnologie,7600,2395,665,1730,103,37,66,56,34,0,13,98
494,BUT - Génie biologique Parcours diététique et nutrition,7598,932,234,698,27,5,22,9,7,0,11,24
3316,BUT - Génie industriel et maintenance,7595,500,463,37,43,42,1,26,9,0,8,48
3304,BUT - Gestion des entreprises et des administrations,7601,1563,897,666,128,66,62,60,58,1,9,110
2326,BUT - Informatique,7596,1454,1319,135,124,117,7,90,13,0,21,124
2718,BUT - Mesures physiques,7597,862,673,189,90,71,19,59,14,0,17,100
3380,BUT - Réseaux et télécommunications,7599,689,623,66,55,52,3,28,20,0,7,52
2153,BUT - Génie biologique Parcours agronomie,2966,855,369,486,64,27,37,52,9,0,3,78
1419,BUT - Génie biologique parcours sciences de l'environnement et écotechnologies,2965,754,380,374,41,24,17,27,6,0,8,52
3304,BUT - Gestion des entreprises et des administrations,2967,1047,573,474,76,41,35,25,18,4,29,84
1300,BUT - Statistique et informatique décisionnelle,24715,326,261,65,27,22,5,5,3,0,19,48
984,BUT - Génie électrique et informatique industrielle,2139,292,270,22,20,18,2,8,5,0,7,52
858,BUT - Génie mécanique et productique,2140,547,499,48,38,35,3,20,12,0,6,48
116,BUT - Management de la Logistique et des Transports,2142,299,223,76,42,29,13,20,6,5,11,56
624,BUT - Métiers de la Transition et de l'Efficacité Énergétiques,2141,321,280,41,15,14,1,2,9,0,4,52
1218,BUT - Techniques de commercialisation,2143,1133,599,534,110,50,60,44,51,2,13,100
1218,BUT - Techniques de commercialisation,2154,1127,610,517,74,42,32,32,28,4,10,84
382,BUT - Information communication Parcours journalisme,20875,1546,743,803,48,23,25,37,3,0,8,50
2653,BUT - Métiers du multimédia et de l'internet,2159,1152,793,359,56,38,18,17,15,0,24,52
2296,BUT - Chimie,5410,743,295,448,44,17,27,28,3,0,13,50
2326,BUT - Informatique,5411,654,581,73,49,47,2,32,7,0,10,52
2653,BUT - Métiers du multimédia et de l'internet,5412,1117,813,304,55,38,17,18,24,3,10,54
2326,BUT - Informatique,2815,1491,1351,140,54,49,5,24,16,0,14,56
2653,BUT - Métiers du multimédia et de l'internet,2816,1755,1165,590,54,32,22,24,23,0,7,56
2153,BUT - Génie biologique Parcours agronomie,2167,833,339,494,49,26,23,26,13,0,10,56
1419,BUT - Génie biologique parcours sciences de l'environnement et écotechnologies,2166,913,419,494,26,10,16,14,5,0,7,28
332,BUT - Gestion administrative et commerciale des organisations,2168,1661,736,925,60,28,32,26,21,0,13,60
3304,BUT - Gestion des entreprises et des administrations,2177,1205,630,575,65,36,29,27,20,0,18,84
984,BUT - Génie électrique et informatique industrielle,2803,850,763,87,63,53,10,35,15,2,11,78
2153,BUT - Génie biologique Parcours agronomie,10176,838,391,447,37,22,15,18,6,0,13,45
3512,BUT - Génie biologique parcours sciences de l'aliment et biotechnologie,10177,918,315,603,72,25,47,37,13,0,22,85
3389,BUT - Génie civil - Construction durable,10173,1862,1510,352,122,102,20,61,37,0,24,130
858,BUT - Génie mécanique et productique,10174,1082,986,96,109,103,6,52,33,1,23,120
3304,BUT - Gestion des entreprises et des administrations,10178,2522,1270,1252,212,116,96,84,61,2,65,222
2326,BUT - Informatique,10175,2114,1925,189,148,139,9,76,58,1,13,156
1218,BUT - Techniques de commercialisation,10179,2004,1089,915,201,103,98,89,87,1,24,181
2153,BUT - Génie biologique Parcours agronomie,10466,964,417,547,35,16,19,15,11,0,9,36
3512,BUT - Génie biologique parcours sciences de l'aliment et biotechnologie,10467,724,228,496,37,13,24,21,12,0,4,36
2566,"BUT - Packaging, emballage et conditionnement",10465,291,115,176,21,9,12,8,8,0,5,28
1300,BUT - Statistique et informatique décisionnelle,10468,522,422,100,28,26,2,15,5,0,8,28
1218,BUT - Techniques de commercialisation,10469,2897,1403,1494,79,28,51,34,38,0,7,80
3316,BUT - Génie industriel et maintenance,7757,457,417,40,44,44,0,24,17,0,3,45
3304,BUT - Gestion des entreprises et des administrations,7759,1957,1052,905,102,44,58,48,47,0,7,103
2326,BUT - Informatique,7758,1004,921,83,67,59,8,41,20,0,6,64
1218,BUT - Techniques de commercialisation,7760,2470,1250,1220,110,52,58,48,54,0,8,103
209,BUT - Carrières sociales Parcours animation sociale et socioculturelle,10827,671,132,539,47,5,42,12,8,6,21,56
1265,BUT - Carrières sociales parcours coordination et gestion des établissements et services sanitaires et sociaux,10828,287,38,249,21,0,21,8,3,2,8,28
1817,BUT - Carrières sociales parcours villes et territoires durables,10829,267,90,177,24,7,17,6,7,0,11,28
3389,BUT - Génie civil - Construction durable,10821,979,821,158,64,55,9,29,29,0,6,70
984,BUT - Génie électrique et informatique industrielle,10822,458,424,34,49,46,3,18,14,1,16,52
2326,BUT - Informatique,10825,1313,1177,136,95,89,6,44,25,0,26,96
624,BUT - Métiers de la Transition et de l'Efficacité Énergétiques,10824,303,260,43,27,25,2,11,11,0,5,48
1218,BUT - Techniques de commercialisation,10826,1274,649,625,83,34,49,33,36,3,11,84
332,BUT - Gestion administrative et commerciale des organisations,3588,1128,474,654,54,13,41,24,26,0,4,60
2773,BUT - Gestion administrative et commerciale des organisations - Entièrement en distanciel,35498,79,33,46,11,7,4,3,6,1,1,14
2718,BUT - Mesures physiques,3584,421,311,110,32,22,10,15,4,0,13,48
2653,BUT - Métiers du multimédia et de l'internet,3587,1163,815,348,70,52,18,29,17,0,24,72
3380,BUT - Réseaux et télécommunications,3585,638,578,60,50,44,6,24,4,2,20,56
3316,BUT - Génie industriel et maintenance,8604,235,215,20,12,12,0,3,6,0,3,26
2948,BUT - Hygiène Sécurité Environnement,8605,528,341,187,43,29,14,24,12,0,7,52
116,BUT - Management de la Logistique et des Transports,8606,265,202,63,37,30,7,11,10,5,11,54
2296,BUT - Chimie,3505,947,419,528,49,21,28,26,14,0,9,72
858,BUT - Génie mécanique et productique,3506,843,776,67,90,83,7,62,19,0,9,94
3304,BUT - Gestion des entreprises et des administrations,3507,1743,862,881,137,66,71,71,45,1,20,140
1722,BUT - Information communication Parcours communication des organisations,3510,1054,305,749,63,10,53,29,20,0,14,56
1752,BUT - Information communication Parcours publicité,3509,827,254,573,92,26,66,43,28,0,21,84
2296,BUT - Chimie,7434,493,248,245,51,25,26,26,10,0,15,78
3389,BUT - Génie civil - Construction durable,7435,1149,974,175,108,90,18,46,37,0,25,122
984,BUT - Génie électrique et informatique industrielle,7436,371,346,25,41,39,2,18,11,1,11,52
858,BUT - Génie mécanique et productique,7437,474,436,38,57,55,2,14,19,1,23,65
3131,"BUT - Qualité, logistique industrielle et organisation",7438,242,194,48,44,37,7,8,19,2,15,52
472,BUT - Réseaux et télécommunications (Seconde année possible en apprentissage),7439,471,432,39,58,58,0,32,21,0,5,52
1265,BUT - Carrières sociales parcours coordination et gestion des établissements et services sanitaires et sociaux,20844,458,71,387,19,1,18,3,4,3,9,22
1817,BUT - Carrières sociales parcours villes et territoires durables,20519,358,121,237,16,5,11,8,3,0,5,28
2653,BUT - Métiers du multimédia et de l'internet,4606,1507,1010,497,52,40,12,19,19,0,14,48
3380,BUT - Réseaux et télécommunications,4605,851,768,83,48,45,3,30,10,0,8,48
1218,BUT - Techniques de commercialisation,4607,2204,1079,1125,91,35,56,46,39,0,6,84
1265,BUT - Carrières sociales parcours coordination et gestion des établissements et services sanitaires et sociaux,4199,768,96,672,47,4,43,10,19,5,13,48
3316,BUT - Génie industriel et maintenance,4196,1039,934,105,53,51,2,19,19,4,11,52
345,BUT - Informatique (Seconde année possible en apprentissage),4197,2037,1859,178,99,92,7,51,36,0,12,100
472,BUT - Réseaux et télécommunications (Seconde année possible en apprentissage),4198,1178,1060,118,77,76,1,28,36,0,13,78
2718,BUT - Mesures physiques,5263,412,340,72,31,29,2,20,4,0,7,56
2653,BUT - Métiers du multimédia et de l'internet,5266,1387,981,406,54,37,17,20,17,0,17,54
3380,BUT - Réseaux et télécommunications,5265,545,494,51,52,50,2,27,17,0,8,52
3143,BUT - Science et génie des matériaux,5264,537,459,78,47,41,6,27,12,0,8,52
209,BUT - Carrières sociales Parcours animation sociale et socioculturelle,11355,553,106,447,32,7,25,9,11,2,10,28
745,BUT - Carrières sociales Parcours assistance sociale,11356,867,56,811,30,2,28,5,12,2,11,28
1817,BUT - Carrières sociales parcours villes et territoires durables,11357,342,116,226,30,6,24,8,11,0,11,28
679,BUT - Génie biologique parcours biologie médicale et biotechnologie,24404,2865,685,2180,29,5,24,5,12,0,12,26
3304,BUT - Gestion des entreprises et des administrations,11353,5228,2442,2786,112,46,66,40,52,0,20,112
2653,BUT - Métiers du multimédia et de l'internet,11354,4105,2737,1368,48,24,24,21,23,0,4,50
332,BUT - Gestion administrative et commerciale des organisations,20017,234,87,147,31,8,23,9,22,0,0,30
1218,BUT - Techniques de commercialisation,20022,394,157,237,32,10,22,5,18,0,9,30
3304,BUT - Gestion des entreprises et des administrations,4463,5090,2637,2453,112,56,56,42,57,0,13,114
116,BUT - Management de la Logistique et des Transports,4464,783,574,209,110,75,35,33,49,4,24,112
1218,BUT - Techniques de commercialisation,4465,5477,2741,2736,140,44,96,61,71,2,6,138
3389,BUT - Génie civil - Construction durable,4341,1618,1315,303,74,54,20,31,40,1,2,75
984,BUT - Génie électrique et informatique industrielle,4342,741,693,48,82,81,1,48,21,0,13,100
858,BUT - Génie mécanique et productique,4343,1406,1301,105,76,70,6,26,38,0,12,68
2948,BUT - Hygiène Sécurité Environnement,4344,970,677,293,75,56,19,41,21,0,13,76
2326,BUT - Informatique,4345,1604,1492,112,90,87,3,38,43,0,9,96
2718,BUT - Mesures physiques,4346,1804,1356,448,106,81,25,82,10,0,14,106
3143,BUT - Science et génie des matériaux,4347,915,767,148,43,37,6,24,12,0,7,44
332,BUT - Gestion administrative et commerciale des organisations,5793,1736,773,963,92,36,56,36,46,0,10,88
3131,"BUT - Qualité, logistique industrielle et organisation",5792,350,245,105,45,35,10,22,8,1,14,52
1817,BUT - Carrières sociales parcours villes et territoires durables,3447,375,127,248,44,20,24,20,14,0,10,56
2153,BUT - Génie biologique Parcours agronomie,3444,545,245,300,26,14,12,19,6,0,1,26
494,BUT - Génie biologique Parcours diététique et nutrition,3443,650,152,498,25,6,19,11,7,0,7,26
3512,BUT - Génie biologique parcours sciences de l'aliment et biotechnologie,3445,460,170,290,49,21,28,28,9,0,12,52
3382,BUT - Génie chimique génie des procédés,3442,578,254,324,49,21,28,30,9,0,10,52
1218,BUT - Techniques de commercialisation,3446,1773,906,867,82,29,53,38,42,0,2,80
1817,BUT - Carrières sociales parcours villes et territoires durables,14754,352,123,229,24,12,12,11,3,0,10,28
344,BUT - Génie civil - Construction durable (Seconde année possible en apprentissage),3119,1275,1026,249,102,88,14,50,41,0,11,104
428,BUT - Génie mécanique et productique (Seconde année possible en apprentissage),3120,565,517,48,42,38,4,20,19,0,3,46
3426,BUT - Gestion des entreprises et des administrations (Seconde année possible en apprentissage),3123,704,364,340,105,45,60,38,51,0,16,104
1156,BUT - Mesures physiques (Seconde année possible en apprentissage),3121,297,234,63,30,26,4,22,6,0,2,48
3530,"BUT - Qualité, logistique industrielle et organisation (Seconde année possible en apprentissage)",3122,191,150,41,26,19,7,13,10,1,2,30
2153,BUT - Génie biologique Parcours agronomie,3838,643,311,332,24,12,12,16,3,0,5,28
679,BUT - Génie biologique parcours biologie médicale et biotechnologie,3839,1845,599,1246,50,12,38,32,10,0,8,56
1419,BUT - Génie biologique parcours sciences de l'environnement et écotechnologies,3837,965,496,469,39,26,13,24,9,0,6,42
984,BUT - Génie électrique et informatique industrielle,3835,754,689,65,59,54,5,29,21,0,9,76
858,BUT - Génie mécanique et productique,3836,996,895,101,74,65,9,34,31,0,9,76
3304,BUT - Gestion des entreprises et des administrations,3841,1950,991,959,130,65,65,84,41,0,5,135
3389,BUT - Génie civil - Construction durable,3909,1027,839,188,25,23,2,10,14,0,1,24
332,BUT - Gestion administrative et commerciale des organisations,3910,1407,577,830,61,15,46,26,30,0,5,58
330,BUT - Gestion administrative et commerciale des organisations - Arts,14016,199,56,143,27,4,23,12,10,0,5,26
984,BUT - Génie électrique et informatique industrielle,11440,2154,1940,214,203,188,15,95,84,0,24,190
428,BUT - Génie mécanique et productique (Seconde année possible en apprentissage),11441,2965,2658,307,117,104,13,37,58,0,22,110
1077,BUT - Management de la Logistique et des Transports - ENEPS destiné aux bacs professionnels (Seconde année possible en apprentissage),21819,98,78,20,14,12,2,0,0,14,0,15
1091,BUT - Management de la Logistique et des Transports (Seconde année possible en apprentissage),11658,530,399,131,63,42,21,19,18,0,26,56
3530,"BUT - Qualité, logistique industrielle et organisation (Seconde année possible en apprentissage)",11657,400,299,101,53,40,13,15,21,0,17,50
344,BUT - Génie civil - Construction durable (Seconde année possible en apprentissage),11618,1996,1607,389,108,86,22,48,48,0,12,105
3491,BUT - Génie électrique et informatique industrielle (Seconde année possible en apprentissage),11619,1381,1257,124,73,66,7,28,31,0,14,96
679,BUT - Génie biologique parcours biologie médicale et biotechnologie,11621,1603,435,1168,53,12,41,27,23,0,3,54
1419,BUT - Génie biologique parcours sciences de l'environnement et écotechnologies,11620,684,362,322,27,17,10,17,10,0,0,27
2053,BUT - Techniques de commercialisation (Seconde année possible en apprentissage),11659,3618,1776,1842,118,40,78,48,56,1,13,120
3491,BUT - Génie électrique et informatique industrielle (Seconde année possible en apprentissage),11661,1175,1059,116,63,61,2,16,24,0,23,66
2653,BUT - Métiers du multimédia et de l'internet,11663,2697,1777,920,61,28,33,18,22,3,18,56
1218,BUT - Techniques de commercialisation,11664,3799,1690,2109,86,24,62,43,40,0,3,88
1799,BUT - Techniques de commercialisation - ENEPS destiné aux bacs professionnels,25199,313,149,164,14,6,8,0,0,14,0,14
3316,BUT - Génie industriel et maintenance,8667,326,307,19,23,22,1,8,4,0,11,48
116,BUT - Management de la Logistique et des Transports,8669,359,269,90,35,27,8,15,11,0,9,74
3143,BUT - Science et génie des matériaux,8668,404,331,73,27,21,6,18,2,0,7,48
3389,BUT - Génie civil - Construction durable,13640,1602,1324,278,51,43,8,17,28,0,6,52
332,BUT - Gestion administrative et commerciale des organisations,8841,1999,951,1048,61,26,35,25,32,0,4,56
2773,BUT - Gestion administrative et commerciale des organisations - Entièrement en distanciel,20358,172,73,99,8,4,4,3,2,0,3,15
1846,BUT - Gestion administrative et commerciale des organisations - Etudes aménagées musique ou sport,8843,159,113,46,28,16,12,18,7,0,3,28
2653,BUT - Métiers du multimédia et de l'internet,8840,1528,1100,428,57,38,19,29,21,1,6,53
2566,"BUT - Packaging, emballage et conditionnement",8838,307,140,167,30,9,21,15,12,0,3,27
3143,BUT - Science et génie des matériaux,8837,703,590,113,26,20,6,17,8,0,1,26
870,BUT - Science et génie des matériaux - Etudes aménagées arts appliqués,8839,174,106,68,21,9,12,16,2,0,3,26
2946,BUT - Science et génie des matériaux - Etudes aménagées musique ou sport (Seconde année possible en apprentissage),8842,214,185,29,23,21,2,19,3,0,1,26
3491,BUT - Génie électrique et informatique industrielle (Seconde année possible en apprentissage),3750,528,485,43,45,40,5,19,10,6,10,50
2318,BUT - Génie industriel et maintenance (Seconde année possible en apprentissage),3751,356,336,20,33,30,3,14,13,0,6,36
1091,BUT - Management de la Logistique et des Transports (Seconde année possible en apprentissage),3753,405,316,89,42,34,8,16,10,2,14,50
2603,BUT - Carrières juridiques (Seconde année possible en apprentissage),8118,1276,265,1011,129,22,107,51,62,4,12,120
2153,BUT - Génie biologique Parcours agronomie,8113,553,255,298,47,19,28,31,7,0,9,54
2948,BUT - Hygiène Sécurité Environnement,8110,373,262,111,48,35,13,30,11,1,6,52
624,BUT - Métiers de la Transition et de l'Efficacité Énergétiques,8111,290,257,33,25,24,1,7,9,0,9,36
3380,BUT - Réseaux et télécommunications,8112,518,475,43,66,63,3,30,23,1,12,70
1218,BUT - Techniques de commercialisation,8117,855,422,433,82,40,42,29,37,0,16,75
128,BUT - Techniques de commercialisation - International Business Management en triple diplôme franco suisse allemand,8119,281,128,153,33,14,19,28,1,0,4,32
2013,BUT - Techniques de commercialisation - Tec2tour Management touristique international en double diplôme franco-allemand,13388,156,53,103,14,4,10,13,1,0,0,15
2676,BUT - Génie biologique parcours sciences de l'aliment et biotechnologie (Seconde année possible en apprentissage),11696,173,50,123,8,2,6,4,3,0,1,16
3186,BUT - Génie biologique parcours sciences de l'environnement et écotechnologies (Seconde année possible en apprentissage),11695,313,127,186,19,9,10,6,6,0,7,32
344,BUT - Génie civil - Construction durable (Seconde année possible en apprentissage),11693,418,295,123,38,23,15,17,11,0,10,50
3304,BUT - Gestion des entreprises et des administrations,11697,554,240,314,56,23,33,22,19,1,14,56
462,BUT - Hygiène Sécurité Environnement (Seconde année possible en apprentissage),11694,310,204,106,34,27,7,15,7,0,12,46
3497,BUT - Métiers du multimédia et de l'internet (Seconde année possible en apprentissage),11698,508,351,157,37,27,10,6,10,1,20,50
1218,BUT - Techniques de commercialisation,11699,483,217,266,50,18,32,12,26,2,10,50
679,BUT - Génie biologique parcours biologie médicale et biotechnologie,11512,3178,809,2369,54,13,41,21,20,0,13,52
494,BUT - Génie biologique Parcours diététique et nutrition,11510,1194,288,906,26,9,17,11,10,0,5,26
3512,BUT - Génie biologique parcours sciences de l'aliment et biotechnologie,11511,877,303,574,24,12,12,10,8,0,6,26
984,BUT - Génie électrique et informatique industrielle,11508,1326,1214,112,79,75,4,23,28,0,28,72
2718,BUT - Mesures physiques,11509,1072,836,236,71,56,15,42,10,0,19,78
1218,BUT - Techniques de commercialisation,11513,5377,2537,2840,125,39,86,60,53,0,12,112
2296,BUT - Chimie,11543,1351,523,828,81,24,57,40,15,0,26,78
3426,BUT - Gestion des entreprises et des administrations (Seconde année possible en apprentissage),25439,5731,2668,3063,89,35,54,33,39,0,17,90
2326,BUT - Informatique,36066,3763,3297,466,91,61,30,33,39,0,19,90
3380,BUT - Réseaux et télécommunications,11544,1666,1475,191,70,62,8,28,27,2,13,68
3389,BUT - Génie civil - Construction durable,16879,1345,1060,285,48,37,11,21,21,0,6,52
3380,BUT - Réseaux et télécommunications,10799,596,517,79,34,30,4,18,6,0,10,39
1218,BUT - Techniques de commercialisation,10801,2095,1125,970,107,56,51,48,49,0,10,112
2326,BUT - Informatique,32873,951,874,77,25,22,3,11,8,0,6,26
679,BUT - Génie biologique parcours biologie médicale et biotechnologie,3238,3077,852,2225,51,8,43,19,26,0,6,52
3512,BUT - Génie biologique parcours sciences de l'aliment et biotechnologie,3237,1002,325,677,51,17,34,21,17,0,13,52
858,BUT - Génie mécanique et productique,3235,1273,1161,112,77,72,5,34,35,1,7,78
332,BUT - Gestion administrative et commerciale des organisations,3242,2559,1157,1402,83,28,55,38,42,0,3,84
3304,BUT - Gestion des entreprises et des administrations,3239,2643,1320,1323,169,88,81,67,71,0,31,168
1722,BUT - Information communication Parcours communication des organisations,35727,1692,393,1299,27,8,19,9,8,0,10,28
1549,BUT - Information communication Parcours métiers du livre et du patrimoine,3243,865,159,706,55,7,48,31,11,0,13,56
2326,BUT - Informatique,3236,2109,1920,189,116,101,15,42,44,0,30,104
2653,BUT - Métiers du multimédia et de l'internet,3240,2173,1509,664,78,62,16,31,24,0,23,78
209,BUT - Carrières sociales Parcours animation sociale et socioculturelle,5758,419,84,335,25,6,19,3,3,2,17,28
2349,BUT - Carrières sociales Parcours éducation spécialisée,17567,797,85,712,20,2,18,3,5,0,12,20
858,BUT - Génie mécanique et productique,5756,665,604,61,34,33,1,15,11,0,8,45
1218,BUT - Techniques de commercialisation,5757,1245,706,539,62,38,24,26,32,0,4,72
984,BUT - Génie électrique et informatique industrielle,8012,325,295,30,50,47,3,27,15,0,8,44
2961,BUT - Génie électrique et informatique industrielle - Parcours Franco-Suisse-Allemand (Triple Diplôme),18385,73,62,11,7,7,0,5,0,1,1,14
2653,BUT - Métiers du multimédia et de l'internet,8014,1119,773,346,95,58,37,38,28,0,29,92
3131,"BUT - Qualité, logistique industrielle et organisation",8013,243,185,58,49,38,11,13,26,4,6,46
3389,BUT - Génie civil - Construction durable,23460,115,84,31,9,7,2,3,3,0,3,12
984,BUT - Génie électrique et informatique industrielle,11857,124,111,13,14,11,3,6,6,0,2,24
3380,BUT - Réseaux et télécommunications,11858,137,110,27,18,16,2,9,5,1,3,24
209,BUT - Carrières sociales Parcours animation sociale et socioculturelle,17208,207,31,176,25,1,24,7,11,3,4,28
1218,BUT - Techniques de commercialisation,11878,343,145,198,26,9,17,8,14,1,3,26
209,BUT - Carrières sociales Parcours animation sociale et socioculturelle,20276,224,36,188,21,4,17,7,12,0,2,26
3512,BUT - Génie biologique parcours sciences de l'aliment et biotechnologie,11767,239,75,164,21,8,13,9,8,0,4,28
3216,BUT - Génie biologique parcours sciences de l'environnement et écotechnologies (Seconde année en apprentissage),32800,178,68,110,10,5,5,4,4,0,2,12
3304,BUT - Gestion des entreprises et des administrations,11768,690,273,417,54,25,29,25,23,0,6,57
2653,BUT - Métiers du multimédia et de l'internet,15532,366,281,85,34,27,7,20,12,0,2,40
857,BUT - Carrières juridiques,2100,1770,421,1349,154,44,110,65,64,1,24,140
1218,BUT - Techniques de commercialisation,2099,887,508,379,111,74,37,43,44,3,21,112
3382,BUT - Génie chimique génie des procédés,2101,384,203,181,32,17,15,13,7,0,12,52
858,BUT - Génie mécanique et productique,2102,756,675,81,39,34,5,16,13,0,10,52
857,BUT - Carrières juridiques,2098,1424,331,1093,63,13,50,25,27,1,10,60
984,BUT - Génie électrique et informatique industrielle,2096,391,356,35,37,35,2,19,10,1,7,68
3131,"BUT - Qualité, logistique industrielle et organisation",2097,140,110,30,29,22,7,7,15,3,4,42
2326,BUT - Informatique,35520,261,225,36,22,20,2,9,8,0,5,22
116,BUT - Management de la Logistique et des Transports,11848,165,114,51,14,10,4,7,5,0,2,24
1722,BUT - Information communication Parcours communication des organisations,3357,345,84,261,29,4,25,18,9,0,2,29
382,BUT - Information communication Parcours journalisme,3356,713,388,325,28,17,11,12,8,0,8,29
345,BUT - Informatique (Seconde année possible en apprentissage),3353,1104,1011,93,119,109,10,83,23,0,13,122
1156,BUT - Mesures physiques (Seconde année possible en apprentissage),3354,810,610,200,98,78,20,75,9,0,14,104
3497,BUT - Métiers du multimédia et de l'internet (Seconde année possible en apprentissage),28592,637,476,161,56,46,10,15,26,0,15,56
472,BUT - Réseaux et télécommunications (Seconde année possible en apprentissage),3355,765,709,56,72,68,4,55,7,0,10,78
745,BUT - Carrières sociales Parcours assistance sociale,11957,538,52,486,27,2,25,6,10,6,5,27
2349,BUT - Carrières sociales Parcours éducation spécialisée,30744,475,66,409,25,3,22,7,9,3,6,27
3512,BUT - Génie biologique parcours sciences de l'aliment et biotechnologie,11955,283,80,203,24,5,19,9,10,1,4,25
1419,BUT - Génie biologique parcours sciences de l'environnement et écotechnologies,11954,350,146,204,22,7,15,9,3,0,10,25
3389,BUT - Génie civil - Construction durable,11952,494,410,84,52,42,10,23,26,0,3,52
3304,BUT - Gestion des entreprises et des administrations,11956,1347,555,792,107,38,69,49,48,1,9,108
2948,BUT - Hygiène Sécurité Environnement,19657,360,233,127,21,19,2,8,11,0,2,24
3380,BUT - Réseaux et télécommunications,11953,429,370,59,53,48,5,29,20,1,3,54
1218,BUT - Techniques de commercialisation,20631,943,422,521,55,22,33,25,28,0,2,56
3304,BUT - Gestion des entreprises et des administrations,7521,1171,626,545,113,55,58,37,50,0,26,127
2326,BUT - Informatique,7520,1298,1223,75,76,73,3,44,28,0,4,78
2653,BUT - Métiers du multimédia et de l'internet,7522,1359,1014,345,88,68,20,36,25,0,27,95
1218,BUT - Techniques de commercialisation,7523,1773,992,781,181,81,100,65,82,1,33,183
984,BUT - Génie électrique et informatique industrielle,4819,229,211,18,15,13,2,11,2,0,2,56
3304,BUT - Gestion des entreprises et des administrations,4820,1078,563,515,70,23,47,26,21,2,21,70
116,BUT - Management de la Logistique et des Transports,4816,243,190,53,12,8,4,4,0,3,5,30
1218,BUT - Techniques de commercialisation,4817,1181,576,605,73,30,43,33,26,1,13,84
3304,BUT - Gestion des entreprises et des administrations,7284,1189,557,632,69,29,40,29,33,2,5,80
1218,BUT - Techniques de commercialisation,7285,1228,621,607,70,30,40,19,30,1,20,80
2948,BUT - Hygiène Sécurité Environnement,7276,687,472,215,49,38,11,20,16,1,12,80
116,BUT - Management de la Logistique et des Transports,7277,439,329,110,64,52,12,11,28,1,24,70
1218,BUT - Techniques de commercialisation,7278,1570,808,762,93,53,40,26,39,1,27,84
3382,BUT - Génie chimique génie des procédés,6512,385,213,172,25,15,10,12,4,0,9,37
3316,BUT - Génie industriel et maintenance,6471,543,504,39,60,56,4,20,31,0,9,67
462,BUT - Hygiène Sécurité Environnement (Seconde année possible en apprentissage),6472,588,411,177,67,51,16,41,18,2,6,76
624,BUT - Métiers de la Transition et de l'Efficacité Énergétiques,6473,419,373,46,48,46,2,15,27,0,6,75
3131,"BUT - Qualité, logistique industrielle et organisation",6474,250,192,58,29,20,9,11,8,1,9,52
3316,BUT - Génie industriel et maintenance,10011,458,426,32,37,35,2,16,10,0,11,50
858,BUT - Génie mécanique et productique,10012,723,673,50,50,46,4,22,24,0,4,52
3304,BUT - Gestion des entreprises et des administrations,10014,1109,542,567,58,27,31,12,32,1,13,56
1218,BUT - Techniques de commercialisation,10015,1443,703,740,50,20,30,18,24,0,8,50
3304,BUT - Gestion des entreprises et des administrations,9901,2297,1035,1262,130,57,73,54,66,0,10,130
2653,BUT - Métiers du multimédia et de l'internet,9902,1553,1065,488,80,70,10,35,30,0,15,80
1218,BUT - Techniques de commercialisation,9903,2508,1130,1378,75,20,55,27,33,0,15,82
3389,BUT - Génie civil - Construction durable,9905,2527,2035,492,98,77,21,37,49,0,12,96
2326,BUT - Informatique,9907,2471,2168,303,45,40,5,18,19,0,8,45
624,BUT - Métiers de la Transition et de l'Efficacité Énergétiques,9906,710,616,94,78,75,3,33,38,0,7,78
2653,BUT - Métiers du multimédia et de l'internet,9908,1790,1213,577,53,28,25,21,22,0,10,52
858,BUT - Génie mécanique et productique,6568,1069,969,100,68,66,2,33,19,0,16,104
3304,BUT - Gestion des entreprises et des administrations,6573,2479,1250,1229,162,78,84,70,73,1,18,168
2326,BUT - Informatique,6569,1497,1359,138,93,92,1,35,35,0,23,95
2718,BUT - Mesures physiques,6570,527,408,119,53,44,9,30,5,0,18,78
1300,BUT - Statistique et informatique décisionnelle,6572,606,495,111,57,52,5,30,5,0,22,56
1218,BUT - Techniques de commercialisation,6574,2686,1373,1313,161,78,83,80,68,1,12,158
2296,BUT - Chimie,4522,2042,828,1214,97,25,72,48,21,0,28,104
679,BUT - Génie biologique parcours biologie médicale et biotechnologie,4528,4063,1055,3008,52,12,40,19,24,0,9,52
494,BUT - Génie biologique Parcours diététique et nutrition,4526,1444,317,1127,27,7,20,11,9,0,7,28
3512,BUT - Génie biologique parcours sciences de l'aliment et biotechnologie,4527,1043,348,695,28,11,17,15,10,0,3,28
984,BUT - Génie électrique et informatique industrielle,4523,1520,1374,146,92,89,3,57,11,0,24,120
3304,BUT - Gestion des entreprises et des administrations,4529,5299,2655,2644,112,50,62,51,53,0,8,110
2326,BUT - Informatique,4524,2316,2102,214,119,110,9,54,53,0,12,120
1156,BUT - Mesures physiques (Seconde année possible en apprentissage),4525,1865,1436,429,97,80,17,62,12,0,23,104
1218,BUT - Techniques de commercialisation,4530,7269,3438,3831,105,43,62,52,52,0,1,106
2296,BUT - Chimie,4608,1431,524,907,67,30,37,35,16,0,16,72
332,BUT - Gestion administrative et commerciale des organisations,11351,3965,1712,2253,74,39,35,24,30,1,19,75
1318,BUT - Gestion administrative et commerciale des organisations - en distanciel,35790,522,221,301,12,6,6,1,4,0,7,14
86,BUT - Information communication Parcours communication des organisations (Seconde année possible en apprentissage),17505,2575,678,1897,43,5,38,13,18,0,12,40
345,BUT - Informatique (Seconde année possible en apprentissage),11349,3952,3501,451,87,76,11,27,39,1,20,88
3131,"BUT - Qualité, logistique industrielle et organisation",11350,784,554,230,44,29,15,17,16,2,9,48
3143,BUT - Science et génie des matériaux,22594,363,295,68,23,19,4,13,3,0,7,32
2296,BUT - Chimie,22593,643,285,358,37,17,20,14,13,0,10,60
332,BUT - Gestion administrative et commerciale des organisations,6666,752,374,378,64,28,36,16,28,2,18,62
116,BUT - Management de la Logistique et des Transports,6665,260,199,61,32,24,8,8,12,6,6,45
984,BUT - Génie électrique et informatique industrielle,8133,368,335,33,37,35,2,13,16,0,8,52
858,BUT - Génie mécanique et productique,8134,681,625,56,40,37,3,20,13,0,7,52
1345,BUT - Génie mécanique et productique - Trinational Mécatronique,8136,99,79,20,10,8,2,8,0,0,2,10
3304,BUT - Gestion des entreprises et des administrations,8140,1475,704,771,128,54,74,59,61,1,7,134
116,BUT - Management de la Logistique et des Transports,8141,451,336,115,51,39,12,17,25,1,8,54
2653,BUT - Métiers du multimédia et de l'internet,8142,1194,841,353,55,39,16,18,20,0,17,54
3143,BUT - Science et génie des matériaux,8135,339,277,62,33,24,9,14,6,0,13,36
2153,BUT - Génie biologique Parcours agronomie,6303,715,308,407,46,20,26,32,3,0,11,56
679,BUT - Génie biologique parcours biologie médicale et biotechnologie,6305,2084,563,1521,50,11,39,23,16,0,11,52
494,BUT - Génie biologique Parcours diététique et nutrition,6301,1023,218,805,27,4,23,13,8,0,6,28
3512,BUT - Génie biologique parcours sciences de l'aliment et biotechnologie,6304,696,237,459,56,18,38,33,9,0,14,56
3382,BUT - Génie chimique génie des procédés,6296,678,358,320,46,25,21,31,5,0,10,84
344,BUT - Génie civil - Construction durable (Seconde année possible en apprentissage),6297,1612,1288,324,102,83,19,47,36,0,19,104
984,BUT - Génie électrique et informatique industrielle,6298,573,520,53,39,35,4,23,8,0,8,76
858,BUT - Génie mécanique et productique,6299,947,859,88,68,64,4,29,18,0,21,74
3131,"BUT - Qualité, logistique industrielle et organisation",6300,253,194,59,24,19,5,8,4,4,8,40
3380,BUT - Réseaux et télécommunications,6302,853,775,78,42,41,1,24,9,0,9,60
1722,BUT - Information communication Parcours communication des organisations,30775,2019,449,1570,83,9,74,51,7,1,24,82
382,BUT - Information communication Parcours journalisme,2325,2113,933,1180,25,8,17,18,2,0,5,26
2053,BUT - Techniques de commercialisation (Seconde année possible en apprentissage),2324,2310,1075,1235,110,44,66,44,48,0,18,112
3047,BUT - Carrières sociales Parcours animation sociale et socioculturelle (Seconde année en apprentissage),2328,337,72,265,24,3,21,2,8,1,13,28
2494,BUT - Carrières sociales Parcours éducation spécialisée (Seconde année en apprentissage),14781,740,81,659,28,2,26,5,11,1,11,28
3131,"BUT - Qualité, logistique industrielle et organisation",2321,457,329,128,70,49,21,33,20,0,17,70
472,BUT - Réseaux et télécommunications (Seconde année possible en apprentissage),2322,748,664,84,60,56,4,31,19,1,9,60
1300,BUT - Statistique et informatique décisionnelle,2327,467,373,94,16,13,3,8,1,0,7,25
344,BUT - Génie civil - Construction durable (Seconde année possible en apprentissage),3984,2381,1933,448,125,102,23,60,58,0,7,120
984,BUT - Génie électrique et informatique industrielle,3985,1008,920,88,49,44,5,23,10,0,16,80
858,BUT - Génie mécanique et productique,3986,1940,1745,195,112,101,11,61,37,0,14,113
3304,BUT - Gestion des entreprises et des administrations,3989,2404,1202,1202,79,32,47,34,32,0,13,80
882,BUT - Science et génie des matériaux (Seconde année possible en apprentissage),3987,594,498,96,49,43,6,30,8,0,11,70
209,BUT - Carrières sociales Parcours animation sociale et socioculturelle,9519,705,161,544,54,14,40,13,18,3,20,56
745,BUT - Carrières sociales Parcours assistance sociale,9520,1197,89,1108,53,4,49,14,17,0,22,56
3304,BUT - Gestion des entreprises et des administrations,9517,5704,2849,2855,173,73,100,67,82,0,24,168
1722,BUT - Information communication Parcours communication des organisations,9522,1378,279,1099,56,13,43,26,25,0,5,56
1549,BUT - Information communication Parcours métiers du livre et du patrimoine,9523,256,49,207,27,7,20,20,3,0,4,28
1752,BUT - Information communication Parcours publicité,9521,804,172,632,27,9,18,11,14,0,2,28
2326,BUT - Informatique,9515,4271,3750,521,167,136,31,70,74,0,23,168
1300,BUT - Statistique et informatique décisionnelle,9516,1484,1181,303,92,58,34,49,21,0,22,92
1218,BUT - Techniques de commercialisation,9518,5058,2259,2799,166,60,106,74,81,0,11,168
2153,BUT - Génie biologique Parcours agronomie,7892,849,374,475,33,19,14,23,5,0,5,39
1419,BUT - Génie biologique parcours sciences de l'environnement et écotechnologies,7891,945,474,471,31,17,14,19,8,0,4,39
3316,BUT - Génie industriel et maintenance,7890,604,549,55,32,32,0,15,4,4,9,56
3304,BUT - Gestion des entreprises et des administrations,7893,2122,1070,1052,91,42,49,40,34,1,16,106
116,BUT - Management de la Logistique et des Transports,7894,649,458,191,53,32,21,17,19,0,17,56
417,BUT - Statistique et informatique décisionnelle (Seconde année possible en apprentissage),2469,557,431,126,33,27,6,11,3,0,19,42
1218,BUT - Techniques de commercialisation,2470,2009,1040,969,54,24,30,21,27,1,5,60
857,BUT - Carrières juridiques,2472,2618,481,2137,93,19,74,33,37,0,23,84
3382,BUT - Génie chimique génie des procédés,2471,702,328,374,29,19,10,14,5,1,9,32
679,BUT - Génie biologique parcours biologie médicale et biotechnologie,3880,1610,501,1109,64,27,37,29,24,0,11,66
3512,BUT - Génie biologique parcours sciences de l'aliment et biotechnologie,3879,612,258,354,47,26,21,27,4,0,16,66
3304,BUT - Gestion des entreprises et des administrations,3881,1892,972,920,132,75,57,73,48,1,10,140
116,BUT - Management de la Logistique et des Transports,3882,534,393,141,62,43,19,36,22,1,3,90
1218,BUT - Techniques de commercialisation,3883,2511,1242,1269,168,62,106,78,79,0,11,170
209,BUT - Carrières sociales Parcours animation sociale et socioculturelle,4665,1589,308,1281,88,13,75,28,29,2,29,84
2296,BUT - Chimie,4660,1560,668,892,102,45,57,56,23,0,23,104
3389,BUT - Génie civil - Construction durable,4661,2765,2212,553,155,116,39,66,74,0,15,155
984,BUT - Génie électrique et informatique industrielle,4662,1468,1351,117,101,94,7,51,35,0,15,134
858,BUT - Génie mécanique et productique,4663,2097,1917,180,103,96,7,49,44,0,10,104
3304,BUT - Gestion des entreprises et des administrations,4664,5059,2626,2433,192,71,121,92,84,1,15,196
3316,BUT - Génie industriel et maintenance,5372,460,431,29,26,23,3,13,7,0,6,45
3304,BUT - Gestion des entreprises et des administrations,5375,1171,639,532,81,50,31,33,28,0,20,105
3530,"BUT - Qualité, logistique industrielle et organisation (Seconde année possible en apprentissage)",5373,327,256,71,37,27,10,14,7,4,12,45
3380,BUT - Réseaux et télécommunications,5374,602,562,40,37,35,2,16,7,2,12,45
1218,BUT - Techniques de commercialisation,5376,1623,870,753,108,52,56,43,50,3,12,110
857,BUT - Carrières juridiques,14842,1788,372,1416,53,15,38,15,23,0,15,56
3304,BUT - Gestion des entreprises et des administrations,2497,1260,671,589,77,40,37,36,32,0,9,80
1722,BUT - Information communication Parcours communication des organisations,2498,1183,284,899,24,3,21,10,8,0,6,28
2326,BUT - Informatique,2495,1105,1001,104,49,46,3,32,11,0,6,50
3131,"BUT - Qualité, logistique industrielle et organisation",2496,162,119,43,19,16,3,8,9,0,2,26
2296,BUT - Chimie,9621,1135,494,641,83,38,45,45,16,0,22,104
3382,BUT - Génie chimique génie des procédés,9622,782,412,370,52,36,16,21,15,0,16,56
984,BUT - Génie électrique et informatique industrielle,9623,820,747,73,63,60,3,23,27,0,13,78
2718,BUT - Mesures physiques,9625,977,751,226,75,63,12,54,2,0,19,91
624,BUT - Métiers de la Transition et de l'Efficacité Énergétiques,9624,553,497,56,63,60,3,24,26,1,12,78
2653,BUT - Métiers du multimédia et de l'internet,9627,1749,1246,503,74,51,23,28,29,1,16,75
3380,BUT - Réseaux et télécommunications,9626,748,663,85,53,50,3,19,18,0,16,56
857,BUT - Carrières juridiques,9629,3337,744,2593,154,29,125,65,69,0,20,140
1218,BUT - Techniques de commercialisation,9628,3271,1598,1673,145,62,83,56,67,4,18,140
3512,BUT - Génie biologique parcours sciences de l'aliment et biotechnologie,3384,568,228,340,46,14,32,35,2,0,9,52
3143,BUT - Science et génie des matériaux,3383,595,512,83,32,27,5,22,10,0,0,52
1218,BUT - Techniques de commercialisation,3385,1614,874,740,82,25,57,37,41,0,4,84
3143,BUT - Science et génie des matériaux,11360,650,531,119,27,16,11,12,3,0,12,40
3316,BUT - Génie industriel et maintenance,11221,986,885,101,49,47,2,19,20,0,10,52
858,BUT - Génie mécanique et productique,11222,1763,1607,156,89,86,3,25,32,0,32,96
3304,BUT - Gestion des entreprises et des administrations,11228,5424,2504,2920,173,78,95,48,87,0,38,170
2948,BUT - Hygiène Sécurité Environnement,11223,573,406,167,49,37,12,13,19,1,16,48
2718,BUT - Mesures physiques,11224,1009,750,259,36,26,10,11,2,0,23,48
1218,BUT - Techniques de commercialisation,11229,7521,3396,4125,183,56,127,70,85,9,19,186
984,BUT - Génie électrique et informatique industrielle,10756,219,195,24,13,9,4,5,2,3,3,42
2326,BUT - Informatique,10757,1023,910,113,45,42,3,23,4,1,17,52
2653,BUT - Métiers du multimédia et de l'internet,10758,717,530,187,56,42,14,22,11,4,19,52
1419,BUT - Génie biologique parcours sciences de l'environnement et écotechnologies,5309,1376,658,718,75,52,23,47,14,0,14,73
984,BUT - Génie électrique et informatique industrielle,5306,1063,966,97,59,52,7,30,23,0,6,68
858,BUT - Génie mécanique et productique,5307,1800,1637,163,92,87,5,39,41,0,12,92
332,BUT - Gestion administrative et commerciale des organisations,5312,2600,1159,1441,111,39,72,54,44,0,13,99
3304,BUT - Gestion des entreprises et des administrations,5310,2777,1413,1364,153,78,75,65,75,0,13,161
2718,BUT - Mesures physiques,5308,1437,1116,321,88,77,11,56,7,0,25,116
1218,BUT - Techniques de commercialisation,5311,3160,1631,1529,154,68,86,71,68,0,15,161
857,BUT - Carrières juridiques,4784,2506,500,2006,72,11,61,33,34,1,4,72
3316,BUT - Génie industriel et maintenance,4780,443,407,36,26,24,2,14,8,1,3,46
3304,BUT - Gestion des entreprises et des administrations,4783,2299,1208,1091,118,75,43,59,44,0,15,117
3380,BUT - Réseaux et télécommunications,4781,691,628,63,77,70,7,37,36,2,2,78
3304,BUT - Gestion des entreprises et des administrations,11112,7363,3682,3681,288,133,155,134,137,0,17,295
1218,BUT - Techniques de commercialisation,11113,8977,3991,4986,344,90,254,138,169,0,37,351
3512,BUT - Génie biologique parcours sciences de l'aliment et biotechnologie,8003,720,253,467,57,17,40,34,8,0,15,60
1419,BUT - Génie biologique parcours sciences de l'environnement et écotechnologies,8002,562,278,284,30,11,19,18,8,0,4,28
3316,BUT - Génie industriel et maintenance,8000,475,434,41,30,28,2,17,9,0,4,30
3304,BUT - Gestion des entreprises et des administrations,8005,1986,1016,970,105,46,59,57,44,0,4,107
1156,BUT - Mesures physiques (Seconde année possible en apprentissage),8001,469,372,97,57,43,14,41,2,0,14,58
3304,BUT - Gestion des entreprises et des administrations,36307,656,344,312,54,35,19,41,10,0,3,58
3304,BUT - Gestion des entreprises et des administrations,9890,1006,512,494,107,53,54,46,48,0,13,108
2326,BUT - Informatique,9889,1206,1083,123,86,79,7,42,36,0,8,84
1218,BUT - Techniques de commercialisation,9891,1301,602,699,27,9,18,11,13,0,3,26
209,BUT - Carrières sociales Parcours animation sociale et socioculturelle,9897,443,100,343,50,9,41,14,12,1,23,50
1817,BUT - Carrières sociales parcours villes et territoires durables,25436,228,79,149,25,10,15,10,8,0,7,24
494,BUT - Génie biologique Parcours diététique et nutrition,25433,786,195,591,27,7,20,9,13,0,5,26
1419,BUT - Génie biologique parcours sciences de l'environnement et écotechnologies,25434,845,401,444,52,29,23,26,19,0,7,53
3389,BUT - Génie civil - Construction durable,25432,1576,1269,307,56,42,14,23,26,0,7,56
984,BUT - Génie électrique et informatique industrielle,9893,855,795,60,80,75,5,42,28,0,10,84
3316,BUT - Génie industriel et maintenance,9894,536,493,43,47,45,2,20,16,0,11,51
3304,BUT - Gestion des entreprises et des administrations,9895,2503,1162,1341,109,40,69,46,52,0,11,110
2326,BUT - Informatique,16692,1254,1106,148,23,20,3,11,10,0,2,20
2653,BUT - Métiers du multimédia et de l'internet,25435,2284,1501,783,106,58,48,34,38,6,28,109
1218,BUT - Techniques de commercialisation,9896,2048,938,1110,107,33,74,52,52,0,3,105
3512,BUT - Génie biologique parcours sciences de l'aliment et biotechnologie,5219,643,234,409,47,21,26,27,15,0,5,52
3380,BUT - Réseaux et télécommunications,5218,465,435,30,36,34,2,21,10,3,2,52
3143,BUT - Science et génie des matériaux,5217,415,344,71,44,41,3,29,13,0,2,52
624,BUT - Métiers de la Transition et de l'Efficacité Énergétiques,7791,448,399,49,57,51,6,26,26,1,4,72
1300,BUT - Statistique et informatique décisionnelle,7792,454,358,96,46,41,5,30,3,0,13,54
3389,BUT - Génie civil - Construction durable,16046,1422,1185,237,49,41,8,20,24,0,5,48
984,BUT - Génie électrique et informatique industrielle,7832,676,615,61,62,59,3,23,24,1,14,72
858,BUT - Génie mécanique et productique,7833,1203,1096,107,82,72,10,40,33,0,9,85
3304,BUT - Gestion des entreprises et des administrations,7834,1816,988,828,126,63,63,59,47,0,20,135
2653,BUT - Métiers du multimédia et de l'internet,7835,996,708,288,55,39,16,18,22,0,15,56
1218,BUT - Techniques de commercialisation,7836,2558,1358,1200,140,79,61,57,67,6,10,135
3304,BUT - Gestion des entreprises et des administrations,10397,855,440,415,62,24,38,27,23,0,12,60
2653,BUT - Métiers du multimédia et de l'internet,10399,1873,1247,626,80,55,25,26,23,0,31,81
679,BUT - Génie biologique parcours biologie médicale et biotechnologie,10358,1933,531,1402,55,17,38,27,19,0,9,55
494,BUT - Génie biologique Parcours diététique et nutrition,10356,726,194,532,23,2,21,7,6,0,10,22
1419,BUT - Génie biologique parcours sciences de l'environnement et écotechnologies,10357,759,391,368,28,14,14,11,10,0,7,26
984,BUT - Génie électrique et informatique industrielle,10353,736,669,67,71,62,9,31,21,0,19,96
3316,BUT - Génie industriel et maintenance,10354,411,375,36,25,24,1,8,11,0,6,36
858,BUT - Génie mécanique et productique,10355,1370,1221,149,96,92,4,48,32,0,16,100
3304,BUT - Gestion des entreprises et des administrations,10359,1944,1023,921,160,78,82,82,53,1,24,163
1218,BUT - Techniques de commercialisation,10360,3109,1422,1687,162,87,75,74,73,1,14,164
2153,BUT - Génie biologique Parcours agronomie,4264,1131,467,664,46,19,27,29,10,0,7,50
3512,BUT - Génie biologique parcours sciences de l'aliment et biotechnologie,4265,786,268,518,21,6,15,9,5,0,7,25
3304,BUT - Gestion des entreprises et des administrations,4266,1888,1058,830,64,45,19,26,22,0,16,67
2948,BUT - Hygiène Sécurité Environnement,4263,857,593,264,42,31,11,14,21,0,7,50
2296,BUT - Chimie,10293,1304,485,819,74,27,47,37,25,0,12,74
2653,BUT - Métiers du multimédia et de l'internet,10295,1327,958,369,58,46,12,13,20,2,23,50
2566,"BUT - Packaging, emballage et conditionnement",10294,271,96,175,23,6,17,11,9,0,3,26
1218,BUT - Techniques de commercialisation,10296,2220,1157,1063,84,44,40,19,33,0,32,68
3382,BUT - Génie chimique génie des procédés,4094,1652,802,850,80,41,39,45,7,0,28,90
3389,BUT - Génie civil - Construction durable,4095,3784,3063,721,190,150,40,74,88,0,28,162
984,BUT - Génie électrique et informatique industrielle,4096,1469,1313,156,137,127,10,56,31,0,50,146
858,BUT - Génie mécanique et productique,4097,3291,2919,372,231,214,17,82,102,0,47,232
3304,BUT - Gestion des entreprises et des administrations,4100,6107,3267,2840,380,229,151,151,181,0,48,320
1722,BUT - Information communication Parcours communication des organisations,4103,3575,823,2752,53,5,48,19,22,0,12,50
3251,BUT - Information communication Parcours information numérique dans les organisations,4102,981,392,589,36,14,22,12,11,0,13,36
1549,BUT - Information communication Parcours métiers du livre et du patrimoine,18833,555,103,452,15,2,13,6,4,0,5,13
2326,BUT - Informatique,4098,3312,2969,343,133,117,16,41,51,0,41,134
1218,BUT - Techniques de commercialisation,4101,7655,3920,3735,161,65,96,66,70,0,25,150
3316,BUT - Génie industriel et maintenance,11334,653,587,66,43,39,4,19,20,0,4,45
3304,BUT - Gestion des entreprises et des administrations,11335,3330,1441,1889,61,25,36,21,29,0,11,60
116,BUT - Management de la Logistique et des Transports,11336,745,545,200,55,37,18,14,24,2,15,56
857,BUT - Carrières juridiques,18735,2009,430,1579,81,10,71,28,37,0,16,84
984,BUT - Génie électrique et informatique industrielle,2423,539,489,50,52,46,6,12,24,1,15,52
858,BUT - Génie mécanique et productique,2424,899,820,79,64,61,3,22,18,0,24,80
3304,BUT - Gestion des entreprises et des administrations,2425,1663,831,832,133,77,56,50,54,0,29,140
2653,BUT - Métiers du multimédia et de l'internet,2426,926,655,271,103,62,41,37,31,2,33,104
1218,BUT - Techniques de commercialisation,2427,1940,999,941,140,60,80,53,63,2,22,140
3304,BUT - Gestion des entreprises et des administrations,3648,2215,1135,1080,172,98,74,81,51,0,40,168
2326,BUT - Informatique,3646,1836,1649,187,78,64,14,40,31,0,7,78
3380,BUT - Réseaux et télécommunications,3647,1019,900,119,47,44,3,20,14,0,13,52
1218,BUT - Techniques de commercialisation,3649,3017,1523,1494,143,72,71,70,63,0,10,140
984,BUT - Génie électrique et informatique industrielle,6956,465,424,41,41,41,0,24,7,1,9,78
3316,BUT - Génie industriel et maintenance,6957,430,386,44,35,31,4,13,9,3,10,65
858,BUT - Génie mécanique et productique,6958,494,446,48,60,55,5,26,19,0,15,91
3304,BUT - Gestion des entreprises et des administrations,6962,1458,750,708,151,71,80,54,42,1,54,168
1218,BUT - Techniques de commercialisation,6963,1867,995,872,165,87,78,61,59,6,39,162
3131,"BUT - Qualité, logistique industrielle et organisation",7197,189,140,49,19,16,3,8,5,0,6,35
1218,BUT - Techniques de commercialisation,7199,1086,609,477,130,78,52,44,48,3,35,124
2326,BUT - Informatique,7192,722,658,64,75,70,5,42,21,0,12,84
2718,BUT - Mesures physiques,7193,190,139,51,16,13,3,4,7,0,5,39
3304,BUT - Gestion des entreprises et des administrations,6469,2760,1438,1322,162,88,74,73,70,3,16,168
2326,BUT - Informatique,6467,1695,1545,150,92,85,7,47,30,0,15,90
1300,BUT - Statistique et informatique décisionnelle,6468,793,625,168,97,78,19,53,13,0,31,112
1218,BUT - Techniques de commercialisation,6470,3541,1736,1805,113,46,67,54,54,0,5,112
3382,BUT - Génie chimique génie des procédés,10016,390,165,225,24,10,14,17,3,0,4,26
332,BUT - Gestion administrative et commerciale des organisations,10018,1857,846,1011,55,25,30,23,27,0,5,56
1218,BUT - Techniques de commercialisation,10017,1690,876,814,85,37,48,40,41,1,3,84
3491,BUT - Génie électrique et informatique industrielle (Seconde année possible en apprentissage),9992,1273,1168,105,55,50,5,31,12,0,12,58
345,BUT - Informatique (Seconde année possible en apprentissage),9993,2840,2569,271,79,75,4,40,36,0,3,76
2653,BUT - Métiers du multimédia et de l'internet,9996,2110,1514,596,55,40,15,16,23,0,16,56
3380,BUT - Réseaux et télécommunications,9994,1201,1072,129,36,34,2,16,14,1,5,38
3304,BUT - Gestion des entreprises et des administrations,11157,3271,1749,1522,51,21,30,19,26,0,6,47
1218,BUT - Techniques de commercialisation,25438,5184,2450,2734,84,26,58,35,40,0,9,82
1549,BUT - Information communication Parcours métiers du livre et du patrimoine,11154,865,187,678,50,5,45,24,3,1,22,50
984,BUT - Génie électrique et informatique industrielle,11058,1527,1404,123,90,87,3,53,29,0,8,86
858,BUT - Génie mécanique et productique,11059,1782,1637,145,85,76,9,26,34,1,24,85
624,BUT - Métiers de la Transition et de l'Efficacité Énergétiques,11060,801,700,101,67,61,6,23,30,0,14,86
857,BUT - Carrières juridiques,11241,4628,990,3638,169,36,133,66,82,0,21,168
984,BUT - Génie électrique et informatique industrielle,11235,1602,1433,169,101,91,10,52,40,0,9,100
3304,BUT - Gestion des entreprises et des administrations,11240,5293,2372,2921,170,69,101,75,81,0,14,163
2326,BUT - Informatique,11236,4362,3765,597,126,107,19,55,61,0,10,128
3380,BUT - Réseaux et télécommunications,11237,2075,1807,268,73,68,5,35,36,0,2,74
1300,BUT - Statistique et informatique décisionnelle,24848,1268,1001,267,26,18,8,11,6,0,9,28
2349,BUT - Carrières sociales Parcours éducation spécialisée,3722,1089,127,962,29,2,27,8,12,0,9,28
679,BUT - Génie biologique parcours biologie médicale et biotechnologie,3719,843,236,607,30,7,23,13,14,0,3,28
494,BUT - Génie biologique Parcours diététique et nutrition,3716,525,129,396,28,6,22,9,9,0,10,28
3512,BUT - Génie biologique parcours sciences de l'aliment et biotechnologie,3718,526,211,315,39,16,23,18,7,0,14,56
3304,BUT - Gestion des entreprises et des administrations,3720,991,505,486,68,24,44,28,27,0,13,84
2718,BUT - Mesures physiques,3715,369,288,81,26,22,4,10,8,0,8,56
2566,"BUT - Packaging, emballage et conditionnement",3717,266,135,131,31,17,14,7,15,0,9,56
1218,BUT - Techniques de commercialisation,3721,1228,629,599,82,27,55,33,40,0,9,84
3491,BUT - Génie électrique et informatique industrielle (Seconde année possible en apprentissage),10957,936,876,60,62,58,4,25,14,4,19,72
858,BUT - Génie mécanique et productique,10958,1296,1175,121,47,44,3,13,21,0,13,65
116,BUT - Management de la Logistique et des Transports,10963,566,413,153,39,25,14,7,13,0,19,40
3131,"BUT - Qualité, logistique industrielle et organisation",10959,440,323,117,43,36,7,12,18,5,8,47
3143,BUT - Science et génie des matériaux,10960,516,448,68,32,30,2,20,8,0,4,40
1218,BUT - Techniques de commercialisation,10964,3385,1536,1849,105,26,79,41,48,2,14,108
3304,BUT - Gestion des entreprises et des administrations,10968,2493,1173,1320,96,49,47,42,46,0,8,96
396,BUT - Métiers de la Transition et de l'Efficacité Énergétiques (Seconde année possible en apprentissage),10967,527,457,70,41,37,4,15,16,0,10,54
1218,BUT - Techniques de commercialisation,10973,2276,1086,1190,33,11,22,15,18,0,0,39
2296,BUT - Chimie,7965,828,371,457,73,39,34,52,7,1,13,88
3389,BUT - Génie civil - Construction durable,7966,1399,1127,272,130,104,26,62,59,0,9,125
2205,BUT - Génie civil - Construction durable - en triple diplôme franco-suisse-allemand,7968,126,84,42,10,7,3,7,2,0,1,9
1722,BUT - Information communication Parcours communication des organisations,7972,1015,249,766,30,3,27,9,14,1,6,30
3251,BUT - Information communication Parcours information numérique dans les organisations,7970,331,137,194,29,13,16,13,11,0,5,30
1752,BUT - Information communication Parcours publicité,7971,748,194,554,31,5,26,14,13,0,4,30
2326,BUT - Informatique,7967,1254,1117,137,95,88,7,41,36,0,18,96
1218,BUT - Techniques de commercialisation,7969,2015,1038,977,117,49,68,54,55,0,8,112
2296,BUT - Chimie,5671,1307,513,794,82,31,51,42,18,0,22,84
858,BUT - Génie mécanique et productique,5672,1302,1192,110,78,77,1,39,24,0,15,78
3426,BUT - Gestion des entreprises et des administrations (Seconde année possible en apprentissage),5676,2926,1482,1444,132,61,71,58,65,0,9,135
345,BUT - Informatique (Seconde année possible en apprentissage),5674,1842,1659,183,99,96,3,47,50,0,2,97
396,BUT - Métiers de la Transition et de l'Efficacité Énergétiques (Seconde année possible en apprentissage),5673,536,468,68,36,34,2,7,19,0,10,50
3530,"BUT - Qualité, logistique industrielle et organisation (Seconde année possible en apprentissage)",5675,467,348,119,40,29,11,21,9,0,10,50
3125,BUT - Chimie (Seconde année possible en apprentissage),10901,1288,480,808,115,43,72,54,29,0,32,125
345,BUT - Informatique (Seconde année possible en apprentissage),10902,3470,3005,465,192,165,27,94,73,0,25,186
2718,BUT - Mesures physiques,10903,1635,1248,387,149,125,24,97,16,0,36,150
984,BUT - Génie électrique et informatique industrielle,8662,366,346,20,39,39,0,18,18,1,2,72
858,BUT - Génie mécanique et productique,8663,630,591,39,71,70,1,45,22,0,4,72
2718,BUT - Mesures physiques,8664,412,323,89,24,19,5,17,4,0,3,72
1218,BUT - Techniques de commercialisation,8665,1244,698,546,129,69,60,52,48,9,20,140
209,BUT - Carrières sociales Parcours animation sociale et socioculturelle,9659,844,147,697,50,3,47,20,17,6,7,56
745,BUT - Carrières sociales Parcours assistance sociale,9660,992,70,922,27,1,26,12,13,1,1,28
3389,BUT - Génie civil - Construction durable,9651,1451,1171,280,95,75,20,47,29,1,18,100
984,BUT - Génie électrique et informatique industrielle,9652,489,462,27,37,35,2,10,12,0,15,50
858,BUT - Génie mécanique et productique,9653,599,549,50,51,49,2,22,24,0,5,52
3304,BUT - Gestion des entreprises et des administrations,9656,1640,815,825,118,44,74,46,49,6,17,135
2948,BUT - Hygiène Sécurité Environnement,9654,668,457,211,52,34,18,25,12,0,15,50
3251,BUT - Information communication Parcours information numérique dans les organisations,9661,488,189,299,22,4,18,13,5,0,4,20
1549,BUT - Information communication Parcours métiers du livre et du patrimoine,9663,745,124,621,22,3,19,19,1,0,2,20
1752,BUT - Information communication Parcours publicité,9662,974,258,716,22,2,20,10,10,0,2,20
2326,BUT - Informatique,9655,1337,1216,121,92,81,11,54,24,2,12,100
116,BUT - Management de la Logistique et des Transports,9657,715,528,187,93,70,23,47,12,6,28,112
1218,BUT - Techniques de commercialisation,9658,1979,978,1001,132,54,78,54,62,3,13,135
984,BUT - Génie électrique et informatique industrielle,3167,301,279,22,36,33,3,17,7,1,11,48
3304,BUT - Gestion des entreprises et des administrations,3168,765,448,317,70,28,42,23,28,1,18,78
3389,BUT - Génie civil - Construction durable,3162,1180,978,202,98,87,11,54,41,1,2,94
209,BUT - Carrières sociales Parcours animation sociale et socioculturelle,15506,687,154,533,42,11,31,14,18,3,7,44
3512,BUT - Génie biologique parcours sciences de l'aliment et biotechnologie,10688,622,230,392,49,12,37,26,12,0,11,48
858,BUT - Génie mécanique et productique,10685,827,745,82,62,58,4,33,15,0,14,72
3304,BUT - Gestion des entreprises et des administrations,10689,1566,811,755,136,64,72,56,65,0,15,140
2326,BUT - Informatique,10686,1216,1115,101,80,73,7,53,20,0,7,72
2718,BUT - Mesures physiques,10687,619,476,143,62,53,9,42,8,0,12,76
2653,BUT - Métiers du multimédia et de l'internet,10690,1374,986,388,52,43,9,24,25,0,3,52
1218,BUT - Techniques de commercialisation,10691,1940,1061,879,136,69,67,51,61,4,20,140
3316,BUT - Génie industriel et maintenance,3169,204,195,9,9,8,1,2,6,0,1,24
2948,BUT - Hygiène Sécurité Environnement,3170,573,409,164,49,42,7,26,20,1,2,56
3316,BUT - Génie industriel et maintenance,10763,198,188,10,3,3,0,1,1,1,0,52
3131,"BUT - Qualité, logistique industrielle et organisation",10764,230,166,64,29,20,9,11,10,4,4,52
1218,BUT - Techniques de commercialisation,10765,979,561,418,102,60,42,56,29,0,17,110
1265,BUT - Carrières sociales parcours coordination et gestion des établissements et services sanitaires et sociaux,7320,246,42,204,22,3,19,7,5,2,8,56
1817,BUT - Carrières sociales parcours villes et territoires durables,7321,214,87,127,31,17,14,13,3,1,14,56
858,BUT - Génie mécanique et productique,7317,408,377,31,41,39,2,13,21,1,6,52
116,BUT - Management de la Logistique et des Transports,7319,291,231,60,35,26,9,11,6,7,11,56
3131,"BUT - Qualité, logistique industrielle et organisation",7318,249,178,71,9,6,3,4,4,0,1,30
679,BUT - Génie biologique parcours biologie médicale et biotechnologie,2855,1934,535,1399,39,8,31,11,18,0,10,40
3512,BUT - Génie biologique parcours sciences de l'aliment et biotechnologie,2854,585,219,366,28,11,17,17,3,0,8,32
1419,BUT - Génie biologique parcours sciences de l'environnement et écotechnologies,2853,934,486,448,30,12,18,18,6,0,6,32
3382,BUT - Génie chimique génie des procédés,2851,630,351,279,38,25,13,18,10,0,10,52
3304,BUT - Gestion des entreprises et des administrations,2856,2087,1068,1019,108,52,56,43,48,0,17,102
2718,BUT - Mesures physiques,2852,839,686,153,102,84,18,68,8,0,26,130
1218,BUT - Techniques de commercialisation,2857,2633,1368,1265,160,62,98,69,79,0,12,162
1300,BUT - Statistique et informatique décisionnelle,2937,517,403,114,34,27,7,25,4,0,5,49
1218,BUT - Techniques de commercialisation,2938,1315,672,643,54,31,23,27,18,0,9,56
2948,BUT - Hygiène Sécurité Environnement,2945,705,463,242,40,25,15,18,14,2,6,50
1722,BUT - Information communication Parcours communication des organisations,2944,1836,496,1340,55,5,50,22,26,0,7,56
1752,BUT - Information communication Parcours publicité,2943,1135,307,828,27,4,23,11,11,0,5,28
2326,BUT - Informatique,2941,1228,1145,83,81,77,4,36,32,0,13,82
3380,BUT - Réseaux et télécommunications,2942,783,724,59,50,48,2,24,13,1,12,50
984,BUT - Génie électrique et informatique industrielle,6039,324,305,19,36,35,1,22,7,0,7,48
3316,BUT - Génie industriel et maintenance,6040,248,223,25,16,15,1,10,6,0,0,36
3304,BUT - Gestion des entreprises et des administrations,6041,845,437,408,74,41,33,36,23,1,14,78
1218,BUT - Techniques de commercialisation,6042,1361,739,622,73,37,36,30,35,0,8,77
624,BUT - Métiers de la Transition et de l'Efficacité Énergétiques,6051,350,304,46,29,24,5,4,15,1,9,44
2653,BUT - Métiers du multimédia et de l'internet,6052,887,623,264,44,34,10,8,17,0,19,42
984,BUT - Génie électrique et informatique industrielle,6374,207,189,18,34,33,1,11,4,6,13,52
3304,BUT - Gestion des entreprises et des administrations,6376,861,454,407,118,67,51,34,54,8,22,135
624,BUT - Métiers de la Transition et de l'Efficacité Énergétiques,6375,135,120,15,22,20,2,6,5,3,8,52
857,BUT - Carrières juridiques,8579,4864,994,3870,154,30,124,69,78,1,6,150
332,BUT - Gestion administrative et commerciale des organisations,8581,3438,1425,2013,94,25,69,40,46,0,8,90
330,BUT - Gestion administrative et commerciale des organisations - Arts,36123,446,108,338,30,5,25,16,9,0,5,30
1722,BUT - Information communication Parcours communication des organisations,8582,2194,442,1752,54,8,46,26,16,0,12,56
3251,BUT - Information communication Parcours information numérique dans les organisations,8580,469,164,305,28,8,20,9,9,0,10,28
679,BUT - Génie biologique parcours biologie médicale et biotechnologie,3056,1982,559,1423,60,15,45,19,26,0,15,58
3512,BUT - Génie biologique parcours sciences de l'aliment et biotechnologie,3055,488,174,314,34,8,26,17,10,0,7,32
3389,BUT - Génie civil - Construction durable,3052,2003,1609,394,110,82,28,58,48,0,4,100
2326,BUT - Informatique,3053,1611,1506,105,99,94,5,60,37,0,2,100
3380,BUT - Réseaux et télécommunications,3054,752,694,58,36,35,1,17,15,0,4,36
1218,BUT - Techniques de commercialisation,3057,4339,2278,2061,169,74,95,71,97,0,1,162
1419,BUT - Génie biologique parcours sciences de l'environnement et écotechnologies,10559,810,429,381,54,31,23,27,15,0,12,52
3304,BUT - Gestion des entreprises et des administrations,10560,1239,682,557,82,39,43,40,28,1,13,82
1722,BUT - Information communication Parcours communication des organisations,10561,1455,327,1128,28,6,22,14,13,0,1,28
1549,BUT - Information communication Parcours métiers du livre et du patrimoine,10562,630,100,530,29,2,27,15,2,0,12,29
472,BUT - Réseaux et télécommunications (Seconde année possible en apprentissage),10558,610,563,47,47,43,4,27,14,1,5,46
679,BUT - Génie biologique parcours biologie médicale et biotechnologie,6232,1873,534,1339,77,23,54,43,28,0,6,78
2326,BUT - Informatique,6231,1002,929,73,51,48,3,27,22,1,1,52
3497,BUT - Métiers du multimédia et de l'internet (Seconde année possible en apprentissage),6233,1078,771,307,79,49,30,34,38,0,7,78
1218,BUT - Techniques de commercialisation,6234,2558,1370,1188,119,65,54,52,57,0,10,110
3125,BUT - Chimie (Seconde année possible en apprentissage),8708,1053,448,605,78,37,41,40,14,0,24,117
858,BUT - Génie mécanique et productique,8709,1368,1272,96,83,80,3,39,33,0,11,91
3304,BUT - Gestion des entreprises et des administrations,8711,2323,1226,1097,156,82,74,69,66,2,19,168
1156,BUT - Mesures physiques (Seconde année possible en apprentissage),8710,844,682,162,38,31,7,26,5,0,7,78
3512,BUT - Génie biologique parcours sciences de l'aliment et biotechnologie,7537,380,148,232,22,13,9,8,4,0,10,32
1419,BUT - Génie biologique parcours sciences de l'environnement et écotechnologies,7536,527,276,251,30,14,16,17,5,0,8,32
984,BUT - Génie électrique et informatique industrielle,7466,233,217,16,30,27,3,6,6,0,18,42
3304,BUT - Gestion des entreprises et des administrations,7468,543,285,258,46,21,25,18,12,1,15,52
2326,BUT - Informatique,7467,738,678,60,75,70,5,38,29,0,8,66
624,BUT - Métiers de la Transition et de l'Efficacité Énergétiques,7107,195,159,36,27,23,4,11,5,0,11,42
1218,BUT - Techniques de commercialisation,7109,795,465,330,93,66,27,41,33,1,18,84
3316,BUT - Génie industriel et maintenance,7529,147,135,12,25,23,2,12,11,0,2,28
332,BUT - Gestion administrative et commerciale des organisations,7530,723,337,386,50,20,30,22,19,0,9,56
1176,BUT - Gestion des entreprises et des administrations (Seconde année en apprentissage),8577,1514,701,813,84,35,49,30,38,1,15,84
1050,BUT - Hygiène Sécurité Environnement (Seconde année en apprentissage),8574,525,349,176,52,32,20,24,23,0,5,52
1394,BUT - Management de la Logistique et des Transports (Seconde année en apprentissage),8578,414,284,130,56,38,18,14,24,0,18,57
1085,"BUT - Qualité, logistique industrielle et organisation (Seconde année en apprentissage)",8575,396,288,108,72,55,17,18,20,3,31,78
3343,BUT - Statistique et informatique décisionnelle (Seconde année en apprentissage),8576,363,295,68,53,45,8,31,7,1,14,56
3512,BUT - Génie biologique parcours sciences de l'aliment et biotechnologie,2033,910,312,598,74,32,42,46,19,0,9,78
3426,BUT - Gestion des entreprises et des administrations (Seconde année possible en apprentissage),2034,1334,671,663,54,24,30,22,26,0,6,54
2326,BUT - Informatique,2032,1807,1621,186,79,76,3,37,34,0,8,72
624,BUT - Métiers de la Transition et de l'Efficacité Énergétiques,2031,697,606,91,57,54,3,28,23,0,6,70
2296,BUT - Chimie,8272,2300,974,1326,121,50,71,64,45,0,12,112
2153,BUT - Génie biologique Parcours agronomie,8277,1282,521,761,45,18,27,23,15,0,7,42
679,BUT - Génie biologique parcours biologie médicale et biotechnologie,8278,3807,1012,2795,46,9,37,15,27,0,4,42
494,BUT - Génie biologique Parcours diététique et nutrition,8276,1344,290,1054,29,7,22,12,8,0,9,28
3382,BUT - Génie chimique génie des procédés,8273,1708,816,892,50,28,22,15,16,0,19,56
3389,BUT - Génie civil - Construction durable,8274,4110,3262,848,143,115,28,63,69,0,11,145
3304,BUT - Gestion des entreprises et des administrations,8279,5527,2778,2749,162,64,98,64,78,0,20,161
2326,BUT - Informatique,8275,4507,4034,473,127,121,6,58,63,0,6,125
984,BUT - Génie électrique et informatique industrielle,8490,2410,2186,224,197,183,14,88,65,2,42,200
3316,BUT - Génie industriel et maintenance,8491,1711,1524,187,78,70,8,25,24,0,29,92
858,BUT - Génie mécanique et productique,8492,3793,3417,376,310,294,16,187,103,0,20,300
1218,BUT - Techniques de commercialisation,8493,8312,3978,4334,223,73,150,94,113,0,16,224
2968,BUT - Techniques de commercialisation des systèmes industriels,8494,961,631,330,58,38,20,21,27,1,9,56
3304,BUT - Gestion des entreprises et des administrations,34945,919,416,503,28,13,15,13,14,0,1,28
2326,BUT - Informatique,34946,582,539,43,26,26,0,19,3,0,4,28
3304,BUT - Gestion des entreprises et des administrations,6315,2014,1079,935,163,89,74,85,56,0,22,168
1722,BUT - Information communication Parcours communication des organisations,6320,1678,429,1249,53,8,45,27,21,1,4,52
3251,BUT - Information communication Parcours information numérique dans les organisations,6318,458,208,250,26,12,14,14,8,0,4,25
1549,BUT - Information communication Parcours métiers du livre et du patrimoine,6321,800,145,655,56,12,44,24,5,1,26,52
1752,BUT - Information communication Parcours publicité,6319,1277,360,917,26,12,14,9,9,0,8,25
2326,BUT - Informatique,6314,1822,1663,159,128,120,8,74,36,0,18,125
2653,BUT - Métiers du multimédia et de l'internet,6316,1098,757,341,56,29,27,18,16,1,21,52
1218,BUT - Techniques de commercialisation,6317,3180,1603,1577,157,67,90,66,67,2,22,162
3491,BUT - Génie électrique et informatique industrielle (Seconde année possible en apprentissage),5479,1143,1056,87,88,84,4,34,37,2,15,90
428,BUT - Génie mécanique et productique (Seconde année possible en apprentissage),5480,2106,1941,165,106,103,3,52,43,0,11,104
3426,BUT - Gestion des entreprises et des administrations (Seconde année possible en apprentissage),5485,4222,2240,1982,208,119,89,98,94,0,16,196
345,BUT - Informatique (Seconde année possible en apprentissage),5482,2668,2411,257,95,89,6,50,38,0,7,90
396,BUT - Métiers de la Transition et de l'Efficacité Énergétiques (Seconde année possible en apprentissage),5481,776,676,100,74,71,3,28,37,0,9,78
3131,"BUT - Qualité, logistique industrielle et organisation",5483,626,462,164,48,39,9,24,11,1,12,78
882,BUT - Science et génie des matériaux (Seconde année possible en apprentissage),5484,1102,936,166,74,66,8,52,17,0,5,78
3491,BUT - Génie électrique et informatique industrielle (Seconde année possible en apprentissage),2249,841,740,101,90,81,9,34,29,0,27,104
3304,BUT - Gestion des entreprises et des administrations,2253,3055,1600,1455,134,53,81,50,64,0,20,140
2326,BUT - Informatique,2250,1323,1203,120,62,55,7,42,11,0,9,63
1218,BUT - Techniques de commercialisation,2254,3702,1820,1882,167,63,104,80,76,1,10,168
2296,BUT - Chimie,10599,1171,474,697,83,31,52,41,10,2,30,98
984,BUT - Génie électrique et informatique industrielle,10600,637,580,57,54,50,4,28,3,0,23,75
858,BUT - Génie mécanique et productique,10601,1225,1132,93,75,73,2,46,16,1,12,79
3304,BUT - Gestion des entreprises et des administrations,10605,2334,1189,1145,165,88,77,96,61,0,8,168
624,BUT - Métiers de la Transition et de l'Efficacité Énergétiques,10602,507,454,53,35,33,2,16,14,0,5,54
2718,BUT - Mesures physiques,10654,485,384,101,18,18,0,14,0,0,4,49
3380,BUT - Réseaux et télécommunications,10655,577,533,44,33,31,2,17,7,0,9,39
1218,BUT - Techniques de commercialisation,10656,1823,950,873,76,32,44,34,37,0,5,82
3304,BUT - Gestion des entreprises et des administrations,10138,1490,813,677,77,42,35,36,27,0,14,82
2948,BUT - Hygiène Sécurité Environnement,10136,686,465,221,56,37,19,31,8,1,16,60
1300,BUT - Statistique et informatique décisionnelle,10137,604,479,125,49,36,13,32,2,0,15,52
209,BUT - Carrières sociales Parcours animation sociale et socioculturelle,6166,613,105,508,46,7,39,15,13,6,12,53
1817,BUT - Carrières sociales parcours villes et territoires durables,16731,277,88,189,20,5,15,7,3,0,10,27
3316,BUT - Génie industriel et maintenance,6164,181,168,13,23,23,0,8,10,3,2,26
3380,BUT - Réseaux et télécommunications,6165,343,311,32,40,38,2,20,8,3,9,40
332,BUT - Gestion administrative et commerciale des organisations,2385,866,375,491,79,33,46,22,40,2,15,80
2948,BUT - Hygiène Sécurité Environnement,2384,445,290,155,46,36,10,21,15,0,10,50
1218,BUT - Techniques de commercialisation,2386,676,325,351,58,33,25,25,25,0,8,55
476,BUT - Génie chimique génie des procédés (Seconde année possible en apprentissage),5554,635,354,281,31,22,9,13,3,4,11,78
344,BUT - Génie civil - Construction durable (Seconde année possible en apprentissage),5555,1861,1511,350,106,82,24,46,56,0,4,100
2318,BUT - Génie industriel et maintenance (Seconde année possible en apprentissage),5556,434,409,25,32,30,2,16,13,0,3,52
1091,BUT - Management de la Logistique et des Transports (Seconde année possible en apprentissage),5558,694,516,178,116,87,29,52,37,6,21,115
1156,BUT - Mesures physiques (Seconde année possible en apprentissage),5557,1044,815,229,41,34,7,20,9,0,12,96
2053,BUT - Techniques de commercialisation (Seconde année possible en apprentissage),5559,2944,1546,1398,161,71,90,76,74,1,10,160
3512,BUT - Génie biologique parcours sciences de l'aliment et biotechnologie,6670,490,163,327,11,6,5,5,2,0,4,24
1419,BUT - Génie biologique parcours sciences de l'environnement et écotechnologies,6669,633,328,305,23,14,9,14,2,0,7,56
3316,BUT - Génie industriel et maintenance,6668,291,275,16,12,12,0,6,3,0,3,52
2948,BUT - Hygiène Sécurité Environnement,29878,488,334,154,21,15,6,11,8,1,1,26
1218,BUT - Techniques de commercialisation,6671,1197,663,534,79,45,34,32,32,1,14,84
